1100111111111111
1000000000000001
1000000000000001
2000000000000001
2200000000000001
2222220000000000
2222220000000000
2200000000000001
2000000000000001
1000000000000001
1000000000000001
1111111111111111